+ + + + + + + + + +
+ + + + + + + + + +
+ + + + + + + + + +
+ + + + + + + + + +
+ + + X + + + + + +
+ + - - + + + + + +
+ + @ - - + - - X +
+ - @ - + - - @ - +
+ * @ X - - - X + +
+ + + + + + + + + +
