+ + + + + + + + + +
+ + + + + X - @ * +
+ + + + + + @ - + +
+ + + + + + + - - +
+ + + - - - - X - +
+ X X - - + + - - +
+ - - - + + + + + +
+ @ @ - + + + + + +
+ - - - - + + + + +
+ + + + + + + + + +
