+ + + + + + + + + +
+ + + + + + + + - +
+ + + + + + + * - +
+ + + + + + + X - +
+ + + + + + + - - +
+ + - - + + - @ - +
+ - @ - + - - - @ +
+ - - - + + - @ X +
+ + - - - X X - - +
+ + + + + + + + + +
