+ + + + + + + + + +
+ X X - - - - @ * +
+ - @ - + - - - + +
+ - - + + + + + + +
+ - @ - + + + + + +
+ - X - + + + + + +
+ - @ - + + + + + +
+ - - + - + + + + +
+ - - X - - - + + +
+ + + + + + + + + +
