+ + + + + + + + + +
+ + - @ - - X - X +
+ * X @ - - @ - - +
+ - @ - X + + + - +
+ + + + + + + - - +
+ + + + + + + - - +
+ + + + + + + + - +
+ + + + + + + - - +
+ + + + + - - - - +
+ + + + + + + + + +
