+ + + + + + + + + +
+ * - + + + + - - +
+ X @ + + + + @ - +
+ @ - + + + + - - +
+ - - @ - - - - X +
+ - X - + + + X - +
+ + + + + + + + - +
+ + + + + + + + + +
+ + + + + + + + + +
+ + + + + + + + + +
