+ + + + + + + + + +
+ X - - X - X - - +
+ - @ - + - - @ + +
+ - + + - + - - - +
+ - @ X - - @ - - +
+ - + - - - * - - +
+ + + + + + + + + +
+ + + + + + + + + +
+ + + + + + + + + +
+ + + + + + + + + +
