+ + + + + + + + + +
+ + + + + + + X + +
+ + + + + + X - + +
+ + + + - + - - + +
+ + + + - + - - + +
+ + + + X - + - - +
+ + + + - - @ - + +
+ * @ - - + @ @ - +
+ - - - - X - - - +
+ + + + + + + + + +
