+ + + + + + + + + +
+ - - - - - - + + +
+ - - - - + X @ - +
+ - + + + + @ @ - +
+ - - + + - - + - +
+ - @ - - - - X - +
+ - - - X - - - * +
+ + + + + - - + - +
+ + + + + X - - - +
+ + + + + + + + + +
